Audit de suivi = Follow-up audit
Bilan (d'un facteur, par ex.) = Report
Cartouche = Cartridge
Criticité = Severity
Dégradation (d'une note) = Decline
Dépêche = News item
Echec / Echoué = Failed (for an audit/task)
En attente = On standby (applications on standby)
Erreur non défini = Undefined error
Evolution = Trend (different from "upgrade" context)
Grille qualité = Quality grid
Impliqué (composant impliqué dans une transgression) = Involved
Information erronnée = Erroneous information
Jalon = Milestone
Joker (un caractère) = Wildcard
Kiviat = Kiviat graph (named after creator Phil Kiviat)
Label = Tag (label/tag de gestion de configuration = tag uniquement pour l'anglais)
Lancement = Start ("run", depending on context)
Lancer = Run
Matricule = ID number (compromise between too-specific "Employee number" and too-generic "Number")
Mesure = Measurement (not the same as "measure"!)
Note = Score
Paramètres = Settings (better than "parameters" in this context)
Partiel = Partially successful
Pictogramme = Icon
Pondération = Weight ; Weighting (depends on context)
Programmer (audit) = Schedule (verb)
Programmé = Scheduled (adjective)
Projet commun = Shared project
Réafficher = Refresh display
Référentiel = Repository
Répartition = Distribution
Seuil = Threshold
Stagnation (d'une note) = Levelling ; Level (depends on context)
Synthèse = Summary
Tendance = Trend
Transgression = Violation
Une erreur s'est produite = An error has occurred
Vue de synthèse (de vos applications) = Overview (of your applications)
